###...|###
#.....+..#
#|.O..|..#
.+-##.+...
.|O..--...
#+--.....#
#....--#.#
###....###
