####..####
#.?#-..|.#
#.-.---+.#
.--.||.|..
##--++-###
#...||.O.?
#?#-++-#.#
####||####
