##....-.##
#|....-..#
#+#.#.####
.|........
#+-#....##
#|##...###
#|....####
####.#####
