####..####
###.--.###
#.|----|.#
..#....#..
..|----|..
#.|-..-|.#
#.|-..-|.#
###....###