####..####
#?..-?...#
###.##...#
.....O....
.|..##-...
#+--##...#
#|.......#
#|.......#
