####..####
#?..|-.O.#
##--+--#.#
....|.....
..|.|..|?.
#-+-##-+-#
#.|....|.#
#.+----+.#
