##..||..##
#.|.++.|.#
#.+-++-+.#
..|....+-.
..|....|..
#-+....|.#
#......|?#
#....-####
