{
    "rows" : 6,
    "columns" : 4,
    "tiles" : [
        "--", "y2", "y2", "--",
        "--", "##", "##", "--",
        "--", "--", "--", "--",
        "--", "--", "--", "--",
        "--", "--", "--", "--",
        "--", "--", "--", "--"
    ]
}