{
    "rows" : 8,
    "columns" : 6,
    "tiles" : [
        "--", "##", "y1", "y1", "##", "--",
        "--", "##", "##", "##", "##", "--",
        "--", "--", "--", "--", "--", "--",
        "--", "--", "--", "--", "--", "--",
        "--", "--", "--", "--", "--", "--",
        "--", "--", "--", "--", "--", "--",
        "--", "--", "--", "--", "--", "--",
        "--", "--", "--", "--", "--", "--"
    ]
}