###############
######....#####
##......C.#####
...----########
..---##########
###############
###############
###############
###############
###############