#####..#####
##.?#-..|.##
##.-.---+.##
..--.||.|p..
###--++-####
##.p.||.O.?.
##?#p++-#.##
#####||#####
