###..||..###
##.|.++.|.##
##.+-++-+.##
...|....+-..
...|....|...
##-+....|.##
##......|?##
##....-#####
