###....-.###
##|....-..##
##+#.#.#####
..|.........
##+-#..<.###
##|##...####
##|....#####
#####.######
