######..#######
#####.--.######
###.|----|.####
....#.pC.#.....
....|----|.....
###.|-..-|.####
###.|-..-|p####
####}....}#####
#####....######
#####....######