#####..#####
##?.p|-.O.##
###--+--#.##
.....|......
...|.|..|?..
##-+-##-+-##
##.|..p.|.##
##.+----+.##
