#####....######
######||#######
####..--..#####
.....-CC-......
..... ##.......
###--####--####
####-....-#####
#####----######
######..#######