######..#######
#####?--|######
###..-.-+..####
......W.|.....
.....###|.....
###_#####--####
###..|..#.?####
#####+..#######
####.+--..#####
####.+--..#####