####..######
##?x.|..####
####-+--####
.....|......
...xxxxxx...
##xx????xx##
##xxxxxxxx##
####xxxx####