####...|####
##.....+..##
##|.O..|..##
..+-##.+....
..|O..--....
##+--.....##
##....--#.##
####....####
