#####..#####
##?..-?...##
####.##...##
......O.....
..|.p##-..p.
##+--##...##
##|.......##
##|.......##
